WWWWW
W P W
WWWWWWWWWW
W    W   W
WWWWWW   W
W        W
W        W
WWWWWWWWWW